NO./sprites/north_wall.xpm



SO      ./sprites/south_wall.xpm
WE                      ./sprites/west_wall.xpm


EA ./sprites/east_wall.xpm
F 125,200,10

C    140,125,10



      

11111111
10000001
10010001
10010101
101 0001
11111111
1000N01
1111111