NO ./sprites/north_wall.xpm
SO ./sprites/south_wall.xpm
EA ./sprites/east_wall.xpm
WE ./sprites/west_wall.xpm
C 135,206,235
F 125,200,10

 111111111111111111111111111111111111111
10000000000000000010000000000000000000001
10000000000000000010000000000000000000001
10000000000000000010000000000000000000001
10000000000000000010000000000000000000001  1
11111111111111111110000000000000000000000111
10000000000000000001000000000000111110000001
10000000000000000000000000000000100010000001
10000000000000000000001110000000100010000001
10000000000000000000000000000000100010000001
10100000000000000000000000000000111110000001
10000000000000000000000000000000000000000001
10000000000000000000000000000000000000000001
10000000000000000000000000000000000000000001
1001111111111111111100001111111111111111111
10000000000000000001000100001
10000000000000000001000100001
10000000000000000001000100001  1
111110000000000001110001000001101111111111
1000011111111111100000000000000000000000001
1000000000000000100110000010000000000000001
1000000000000000101  111110000000000100011
1000000000000000101 1000010000000001 101
1000000000000000111 1000010011111111 101
1000000000000000101 10000101  100001 101
1000000000000000100100000111  1000011001
1000000000000000100100000101 10000010001
1001111001111111100100000100100100011101
101    100000000001100000100100000010001
101   1000000000000101111100100000011001
111    1111111110011000000010000000110001
101             1010000000000001101110101
100111111111    101000111001001  10100101
1000000000001   101001   1010001100100101
10000000000011110001111111001001111101001
 1111111000100000000000000101010000000001
        101111111100000000001000000000001
        10000000000001111111111011111111
        100000000000000000000001
 111111101111111111111111111111011111111
10000000000000000000010000000000000000001
10000000W00000001111100000000000000000001
10000000000000000000100110000010000000001
10000000000000000000101  1111100000010001  1
11111111111111110000101  1000010000010000110111111111111
10000000000000100000111  10000100000000000000000000000001
10000000000000100000101 100000100011000000000000000000001
1000011100000010000010010010001001  100000001111111111001
100001 100000010000010010000001001  10000001   111    101
1000011100000010111110010000001001  10000001  1001    101
1000000000000010000000110000001001 100000001  1001    101
10000000000000000000000100110010001001000001  1001111 101
10000000000000001111000101 10010001000000001  10000011101
1001111111111111    101000110010000000000000111000001 101
101                 1001001111100000000000000000011111001
101                  100000000000000011000000000000000001
101                   111111111001101  1000000000000000001
101                            101100110000000000000000001
100111111111111111111111111    101100000000000000000000001
1000000000000000000000000001111001100000000000000000000001
1000000000000000000000000000000000000000000000000000000001
 111111111111111111111100000000000000000000000000000000001
                       10000000001000000000100000000000001
                       10000000001011111111 1111111111111
                       1000000000001
                        11111111111