NO ./sprites/north_wall.xpm
SO ./sprites/south_wall.xpm
EA ./sprites/east_wall.xpm
WE ./sprites/west_wall.xpm
C 135,206,235
F 125,200,10

 111111111111111111111111111111111111111
10000000000000000010000000000000000000001
10000000000000000010000000000000000000001
10000000000000000010000000000000000000001
10000000000000000010000000000000000000001  1
11111111111111111110000000000000000000000111
10000000000000000001000000000000111110000001
10000000000000000000000000000000100010000001
10000000000000000000001110000000100010000001
100000000000000E0000000000000000100010000001
10100000000000000000000000000000111110000001
10000000000000000000000000000000000000000001
10000000000000000000000000000000000000000001
11111111111111111111111111111111111111111111