NO ./sprites/teste1.xpm
SO ./sprites/teste1.xpm
WE ./sprites/teste1.xpm
EA ./sprites/teste1.xpm
C 135,206,235
F 119,136,153

1111111111111111111111111111111111111111
10000000000000000010000000000000000000001
10000000000000000010000000000000000000001
10000000000000000010000000000000000000001
10000000000000000010000000000000000000001  1
11111111111111111110000000000000000000000111
10000000000000000001000000000000111110000001
10000000000000000000000000000000100010000001
10000000000000000000001110000000100010000001
1000000000S000000000000000000000100010000001
10100000000000000000000000000000111110000001
10000000000000000000000000000000000000000001
10000000000000000000000000000000000000000001
11111111111111111111111111111111111111111111