



NO     ./sprites/north_wall.xpm


         SO ./sprites/south_wall.xpm
   
   WE ./sprites/west_wall.xpm
                          
                          
                          
                          EA ./sprites/east_wall.xpm

 F 125,200,10
C 140,125,10 
		   




   111111111
11110000001111
11110000000001
 111100001111111 
10000000000111111
10010001001 	   111
10000101001
1N000001001        1111
11111111111 



