NO sprites/north_wall.xpm
SO sprites/south_wall.xpm
WE sprites/west_wall.xpm
EA sprites/east_wall.xpm

F 20,20,20
C 200,200,200

S1111
10001
10001
10001
10001
10001
11001
10001
10001
10001
10001
10001
11111
